1010011111
1000000011
1001111101
1011101001
1000101001
1110101011
1011101011
1001111001
1000000011
1111111111
