1011111111
10100C0E01
1010101111
1010100C01
1011100001
10000P0001
1000000001
10011100C1
1000000001
1101111111
1C00011011
1000000001
0000000000
1000000001
1101111110
