11111111111
10000000001
10000000001
10000000111
11111100101
1P000000001
10000000101
10111111001
10000000101
10E00000001
11111111111
