1111111111111111111111111111111111111111111111111111111111
1CCCC000100001000CC0000010000C000C1000000100000C0000C00001
10000000000000000001000010CC000100100010010000000000001001
1000000011111111110111001000000100100010011111111110C01001
1111110010000CC00100010010011101001000100000C0000110001C01
1P00000010000100010001001000000000100010000000000110001001
1000000010000100010001001100010000100010001111100110C01001
1011111110000100010C010C0100010000100010000001000011001001
10000000100C010001000100011111000010001000000100C000001001
10000CC000000100CC00010000000000000000100000010000C00010E1
1111111111111111111111111111111111111111111111111111111111
