11111111111
10000000001
1000C000001
10000000111
11111100101
1P000000001
10000000101
10111111101
10000000101
10E00CC0001
11111111111
