11111111111111111111
100000000E0000000001
10000000000000000001
10000000C00000000001
100000000000000C0001
10C00000000000000001
10000000000000000001
100000000000000C0001
1000C00000C000000001
10000000000000000001
100000000000000C0001
100000000000000000C1
10000000000000000001
10000000000000000001
10000000000C00000001
1000C000000000000001
10000000000000000001
10000000000000000001
1C0000000P00000000C1
11111111111111111111
