11111111111
1C000000001
10000000001
10000000111
11111100101
1P0000E0001
10000000101
00111111001
10000100101
10000100001
11111111111
