11111111111111
11000E00000001
11100000010001
10000C00000001
10000000000011
100000P0000011
11111111111111
