1111111111
1000C00001
1000000001
1000000011
1111110011
1P00000001
1000000011
1011111101
1000E00011
1111111111
